        111111111
        100100001
        10000CCC1
        00010CCC1
        100111111
        100100001
        100000001
        100100001
        100100001
11111111100100001
10000000000100001
10000000000000001
10000000000100001
10000000000100001
11111111100111111
        1001
        1001
        100111111
        100100001
        100100001
        10000CCC1
        100111111
        111111111
