111100111111
1CC0000CCCC1
1CC0000CCCC1
1CC0000CCCC1
1CC0000CCCC1
1CC0000CCCC1
1CC0000CCCC1
1CC0000CCCC1
1CC0000CCCC1
1CC0000CCCC1
1CC000000001
111100110011
       10001
       10001
       10001
       11111