111111
1CCC01
1CCC01
1CCC01
1CCC01
1CCC01001111111
1CCCC000CCCCCC1
1CCCC000CCCCCC1
1CCCC000CCCCCC1
1CCCC000CCCCCC1
1CCCC000CCCCCC1
1CCCC000CCCCCC1
1CCCC000CCCCCC1
1CCCC0000000001
100000011111111
111111111111111