111111111111111
101111111100001
101111111100001
101111111100001
1000C00000C00C1
10CC0000000CC01
1C00C00000C00C1
100000000000001
100C0C00000C0C1
10C0C0000CC0C01
1C00C00000C0C01
100C0C00000C0C1
100000000000001
111110001111111
1CCCC000CCCCCC1
1CCCC000CCCCCC1
1CCCC000CCCCCC1
100000000000001
111111001111111