1111111
1000001
1000001
1000001
1110001
10000000001
1CC0000CCC1
1CC0000CCC1
1CC0000CCC1
1CC0000CCC1
1CC0000CCC1
1CC0000CCC1
11110011111